我下個禮拜會開個派對	sbebesssbe
我因為超速俾人抄牌	sbebessbe
你嗰陣時有冇諗過放棄	sbmebebebe
中國嘅伊斯蘭教會	besbmebe
我係大學幹事會嘅成員	ssbebmesbe
佢哋都住喺美國	besssbe
兩個都仲係細	besbes
連細蚊仔都識啦	sbmesss
佢都走咗十日喇	ssssbes
你唔好成日就佢	sssbess
佢話要咩你都買	sssssss
啲嘢放咗喺邊	ssssss
唔好講大話啦	ssbmes
我知道你在想什麼	sbesssbe
我老闆想我今晚十點之前做完啲嘢	sbessbebebebess
除非我聽日要加班	besbesss
唔係我哋就聽日見	bebesbes
佢哋畀咗啲錢我哋去買嘢食	bessssbessbe
我已經寫明係七點鐘開始嘅	sbebesbmebes
佢應該不過五十公斤	sbebebebe
你幾時先返香港	sbessbe
如果件事穿咗就弊喇	besssssss
我真係唔明白佢點解噉做	sbesbesbess
媽咪好似返咗嚟啦喎	bebesssss
啲細路唔識點樣過馬路	sbessbebme
佢過咗五十歲啦	sbebess
佢啱啱走過我隔嚟	sbebesbe
啲細路匿埋喺張枱下面	sbebesssbe
佢好摺所以冇咪朋友	sbebessbe
你可以叫我阿東	sbessbe
蘇軾又叫東坡居士	bessbebe
唔好叫咁大聲	ssssbe
係我叫佢咁做嘅	ssssbes
我最鐘意嘅台灣歌手就係盧廣仲	ssbesbebessbme
呢幅畫像畫得好似	ssbessbe
其實你一啲都唔肥吖	besssssss
佢話唔會嫁人喎	ssbebes
我好開心可以見到你	ssbebebes
我諗你已經知道咗呢本唔係普通嘅筆記啦	sssbebesssbebesbes
佢哋住喺間好大嘅屋度	besssbesss
我可以問個問題嗎	sbessbes
前日有人搶佢件衫	bebessbe
你覺得英國同香港有啲乜嘢分別	sbebesbessbebe
瓦礫責死咗兩個人	bebesbes
嗰個城市有兩間大學	bebesbebe
而啲學生就佔咗人口嘅兩成	ssbesbebesbe
佢哋喺度睇緊乜嘢呀	bessbebes
將啲邋遢衫攞去洗咗佢	ssbesbesss
乜你咁大個人重戽被㗎	ssbebesbes
呢啲花好靚係咪呀	ssssssss
呢啲係咩嘢花嚟㗎	sssbesbe
譬如電影入面嘅唐僧	bebebesbe
係一個囉唆到連綁架佢嘅妖怪都頂唔順嘅口水佬	sbebessbessbesssssbme
譬如觀音喺電影入面係一個普通到同我哋一樣會發脾氣發爛渣嘅女人	bebesbebesbebessbebesbmebmesbe
當遇到唐僧囉唆到令人髮指嘅時候都會忍唔住想殺死佢	sbebebesbebesbessssssbes
如果飲茶嘅話嗰個雞腳唔叫雞腳叫鳳爪	bebessssbessbesbe
再係噉落去會輸晒啲錢架	sssbesbesss
你會唔會申請嗰份工呀	ssssbesbes
佢夠唔夠經驗申請嗰份工呢	ssssbebesbes
我識講四種語言	sbessbe
真嘅係邊幾種呀	sssssss
我想學好講嘢先	ssssbes
當我講得好嘅時候就會開始學寫	ssssssbessbess
而家我只係想留到最後先至學寫	besbesssbebess
我哋唔希望貿貿然去消耗大家嘅民氣	besbebmesbebesbe
我哋希望係藉住今次嘅依個和平集會去調節番大家對未來嘅想像	bebesbebesbebebesbesbesbesbe
我哋希望藉住今次依個集會能夠將獨派或者本土派送上一個健康發展嘅道路	bebessbebebebesssbebesbebebebesbe
我哋藉住依啲集會我哋能夠不斷建立我哋嘅勢力越滾越大	bebebebebebebebebesbessss
過往嘅集會嘅問題就係會固步自封啦	besbesbesssbmmes
集到去一個人數都好我哋都唔會有咩行動	sssbebessbesssbebe
或者甚至有人去行動嘅時候會有人去阻止	bebebesbesbesbesbe
但係我哋民族黨或者我哋獨派嘅集會係唔會嘅	bebebesbebesssbessss
如果到有足夠嘅群眾足夠嘅人數	bessbesbebesbe
你哋覺得要有啲行動嘅時候	bebesssbesbe
覺得時機係到嘅時候	bebesssbe
我哋係絕對唔會阻止	besbebebe
依個係我哋嘅分別	besbesbe
你打咁多機唔覺得好嘥時間嘅咩	ssbesssssbmess
你當佢講估仔咯	ssssbes
跟住佢夜晚黑八點先至完	besbesbebes
呢位係阿明我哋已經見過面喇	sssbebebessss
我唔係好清楚但係我唔係揸得好快啫	sbesbebesbesssss
佢去車站度等火車	ssbessbe
佢拎住一個袋	sbebes
佢枕住健身個肌肉都係咁鬆婄只得半粒老鼠仔咋	sbebesbesssbessssbess
條路一向都好靜	ssbesss
唔係有好多車行	besssss
哦呢度你行得到	sssssss
你應該為你所講嘅嘢道歉	sbessssssbe
我阿媽又嗌我去相睇	sbessssbe
夢想可唔可以成真呀	bessbebes
我哋被逼等咗兩個鐘	bebessbes
我哋好唔好叫架的士呀	besssssbes
唔使喇我哋坐巴士就得喇	sssbesbesss
問吓佢有冇兄弟姊妹	sssssssss
佢有一個哥哥同埋兩個妹妹	ssbebebebebe
你想唔想今晚去睇戲呀	ssssbesbes
套戲幾點開始呀	ssbebes
請番嚟嘅所謂專家其實係個學生	ssssbebebessbe
我哋用咗萬二蚊嚟買呢架車	bessssssssss
